6
         h      p    --s--       p    A
         h     w     w       h   h    A
         h      D    --s--   h   h    A
         h      B    w     www        A
         h      C    p       --s--    A
         h      wwwwwwwwwww   p       A